########
#.##@@*#
#.##@###
#.#@@###
#.##@@@#
#o@@@#@#
########
