############
#.#......#.#
#.#.######.#
#.#@@@@@@@@#
#.#@######@#
#.#@@@.#@@@#
#.###@*#@#@#
#@@@####@#@#
#@#@#..#@#@#
#@#@#.##@#@#
#o#@@@@@@#@#
############
