############
#..#*#...#.#
#.##@#.###.#
#...o......#
##.#.#####.#
#..#.#.#...#
#.##...#.#.#
#..#####.#.#
##.##..#.#.#
#...#.##.#.#
#.#......#.#
############
