############
#..#*#...#.#
#.##@#.###.#
#..@o@.....#
##.#@#####.#
#..#.#.#...#
#.##...#.#.#
#..#####.#.#
##.##..#.#.#
#...#.##.#.#
#.#......#.#
############
