#######
#.....#
#.....#
#..*@@#
#@@@o@#
#@@@@@#
#######
