...#.#.#.#o....#.....
...#.##@@@@#.#..##...
.###@@@@#....#.....#.
#@@@@....###...###.##
@@.#.#..######..#..##
@.##....#.#..........
@@##.##...##..#.....#
#@.#..#.#.##......##.
@@##...####.##.#....#
@.##.........#..#####
@..#...#.#...#.#...##
@....##...#...#.#.###
@@.......#.##..#.#...
#@#...#...#.##.......
#@#.......#..#.#....#
#@##.....#...#.....#.
@@@@#@@@@@@@@###....#
@@@@@@#@#@##@@....##.
#@@@##.#.##.#@...##..
##@#....###@@@#....#.
.#@@#.#.#.*@...#..#.#
