...#@#.#@#o@@@@#@@@@@
...#@##@@@@#@#@@##@@@
.###@@@@#@@@@#@@@@@#@
#@@@@@@@@###@@@###@##
@@@#@#@@######@@#@@##
@@##@@@@#@#@@@@@@@@@@
@@##@##@@@##@@#@@@@@#
#@@#@@#@#@##@@@@@@##.
@@##@@@####@##@#@@@@#
@@##@@@@@@@@@#@@#####
@@@#@@@#@#@@@#@#...##
@@@@@##@@@#@@@#.#.###
@@@@@@@@@#.##@@#@#@@@
#@#@@@#@@@#@##@@@@@@@
#@#@@@@@@@#@@#@#@@@@#
#@##@@@@@#@@@#@@@@@#.
@@@@#@@@@@@@@###@@@@#
@@@@@@#@#@##@@@@@@##.
#@@@##.#.##@#@@@@##..
##@#....###@@@#@@@.#.
.#@@#.#.#.*@@@@#@.#.#
